80 79
S                                          #                                    
                                     ######F  ##                                
                                 ########### ###### #                           
                               ############# ######## #                         
                             #######      ####   ###### #                       
                            # ##    #   # ###############                       
                           ####       ##################                        
                        # # ###### ################### ##                       
                        ## ####  ####### ##############  #  #                   
                        #############   # #############   #                     
                        ##########    ##### ###### #####   ##                   
                        ## ######       #  #  #### ######                       
                        # #####        # ###### ## ##### #  #     #    #        
                        ###### ### ##   #  ## #### # ### ## #   ##      #       
                          #######          # ##### # ###  ##   ####  #  # #     
                          ##### ##          # #   # ###### #   # ##   ## ## #   
                          #### # #          #      #######      ##    # ## ##   
                         ###   #                # # #   ###    ### ###### # #   
                           #       #            #  #        #  # ##  # # # # #  
                                          ##   #      # ####   # ## ##  ##### # 
                            #               #      ##         ## ###### ###  #  
                            #    #       ##       #              # ####  #      
                            #       ##     #  #            #    # #  ## #  #    
                                        # ###      #          ##   ## ##        
                          #         #                #       #   ##  ####       
                        ##        # ##                       ##  #    #  #      
                      #            #                 # ##     #    ##    #      
                #                                                 ######        
              #               #                                     ###         
            ##                                         ##                       
            #                                           #    ##                 
            # #                                         #                       
            #                                           #        #####          
             #                                                     #            
                                                        #   # #    ##           
              #                   ###    #    #         #  #      # #           
              #                  #########           #     #      ##            
              #                 ########                #        #              
                              ########      ##           #       ##             
               #  ####         #     ###  ###  #        #                       
               #                           #                    ###             
                             #          ####                                    
                             #          ##       #             #                
                                     #  #                     ##                
                #                  ####          #            #                 
                                ##### #                      ####               
                                  ### #            #          #                 
                 #       #        #                #       #                    
                                       #                  # #                   
                                                                                
                  #                                  #                          
                  #                       #                                     
                                                                                
                                                                                
                #                                                               
                                               #                                
              ##        #                      #                                
              #                                 # #                             
              #         #                        #                              
              #                                   # #                           
              #        #  #                                                     
                                                    # #                         
                          #                         # #                         
                     #   #                          ##                          
            #        #  #  ###        #              ####                       
            #       #   # ####        #              ## #                       
                        #  #####      #              ## #                       
           #    #  #       ######    ##              ##                         
        #      ### #       # ####   # #              #                          
                  ##     ####### ##   #                 ###                     
       #           #     ########    #                 ###                      
        #             #   ###########                 ####                      
           #  #   #   # ######### #  ##              #### #                     
      #      ###      # # ##########                 #### #                     
             # #      #  ###########  #             ##### #                     
              #       # ############                ##### #                     
  #           #       # ############                ##### #                     
#     #               ##############  #            ###### #                     
#   # #    #          ##############  #            ###### #                     
