61 33
  ###########################################################
S         #         #       #   #         #       #       # #
# ##### ### # ##### # # ### ### ### ##### ### # ### ### # # #
#     #     #     #   #   # #   #       #   # # #   #   #   #
### ### ####### ########### # ### ### ######### ##### ### ###
#     #     # #     #     # #     #   #   # #   #       #   #
# # ##### ### # ######### # # ### # ### ### # ### ####### ###
# #   # # # # # # #       #   #   #   #     #           #   #
### # # # # # # # ####### ####### ### ##### ####### # #######
# # # # # #     # # #         #     #   #           #   #   #
# ### # # ### ### # # ######### # ### # ##### # ### # ### ###
#   # #     #   #               #   # #   # # #   # # # # # #
# # # # ####### ### # ### ##### ##### # # # ### # # # # # # #
# #     # #   #   # #   #   #     # # # #   #   # # # # # # #
####### # # ######### ####### ##### # ### # # # # # ### # # #
#     #     #   # #   #   # # #   #     # # # # # #         #
# # ##### # # ### # # # ### ### ##### # # ############### # #
# #       #     # # #   #   #     #   # #     #   #       # #
# ############# # # # ### ####### # ##### ####### ### # # # #
#     # #     #   # #             # #     #   # #     # # # #
# # ### ### # ### ### # ### ### ### ### ### # # ### ##### # #
# #   #     #   #     # #     # #   #   # # # #       # # # #
# # # ##### # ### ### # ####### ### # ### # ##### ##### ### #
# # # #     #   #   #       #   # # #   #   #     #     #   #
# ##### # ##### ####### # ### ### ### # # ##### ##### ##### #
#   # # #   #     #     # #   #     # #   #   # #     #     #
# ### # ##### # # ### ##### ### ### # ####### # ### # ### # #
# # #   #     # # # #     # #   #   # #   # #   #   # # # # #
### # # ### ##### # # # ### # # ##### # # # # ### ### # # # #
# #   # #       #     #   # # #         #       #   # #   # #
# ##### ####### # # ### # ### ##### # # ### # # # # ### ### #
# #   # # # # # # # #   # #   #   # # # #   # #       #     #
# # ##### # # # ### ### ####### # # ### # # ##### # ##### F #
