10 10
##########
F        #
######## #
#      # #
# #### # #
# #S## # #
# #    # #
# ###### #
#        #
##########
