5 10
#####
#F# #
#   #
# # #
# # #
# # #
# # #
# # #
# #S#
#####
