7 10
#######
###F# #
# # # #
#   # #
# ### #
# #   #
# # # #
# # # #
#   #S#
#######
